R R R R R R R R R R R O O R R R R R R R R R
R O O O O O O O O O O O O O O O O O O R O O
R O O O O O O O O O O T T O O O O O O R O R
R O O O O R O O R R O T T O O R R O O O O R
R O O O O O O R O O O O O O O R O O O O O R
R O O O O O O O O O O O O O O O O O O O R R
R O O O O H H O O O O O O O O O O O O O O R
R O O O O H H O O O O O O O O O O R R O O O
O O O O O O O R O O O O R R O O O R O O O O
O O O O O O O R R R R R R O O O O R O O O O
O R O O O O O R O O O O O O O O O R O O O R
R R R R R R R R R R R R R R R R R R R R R R